+---+---+---+---+---+---+---+---+---+---+---+---+---+---+---+
| . | . | 1 | . | . | . | . | . | . | . | 3 | . | . | . | . |
+---+---+---+---+---+---+---+---+---+---+---+---+---+---+---+
| . | . |   | . | . | . | 4 |   |   |   |   | . | . | . | . |
+---+---+---+---+---+---+---+---+---+---+---+---+---+---+---+
| . | . |   | . | . | . | . | . | . | . |   | . | . | . | . |
+---+---+---+---+---+---+---+---+---+---+---+---+---+---+---+
| 9 | . |   | . | . | . | . | . | . | 5 |   | . | . | . | 7 |
+---+---+---+---+---+---+---+---+---+---+---+---+---+---+---+
|   | . | 2 |   |   |   |11 |   | . |   | . | . | . | . |   |
+---+---+---+---+---+---+---+---+---+---+---+---+---+---+---+
|   | . | . | . | . | . |   | . | . |   | . | . | . | . |   |
+---+---+---+---+---+---+---+---+---+---+---+---+---+---+---+
|   | . | . | . | . | . |   | . | . |   | . | . | . | . |   |
+---+---+---+---+---+---+---+---+---+---+---+---+---+---+---+
|   | . | . | . | . | 8 |   |   |   |   | . | . | . | . |   |
+---+---+---+---+---+---+---+---+---+---+---+---+---+---+---+
|   | . |13 | . | . | . |   | . | . |   | . |15 | . | . |   |
+---+---+---+---+---+---+---+---+---+---+---+---+---+---+---+
|   | . |10 |   |   |   |   | . | . |   | . |   | . | . |   |
+---+---+---+---+---+---+---+---+---+---+---+---+---+---+---+
|   | . |   | . | . | . | . | . |12 |   |   |   |   | . |   |
+---+---+---+---+---+---+---+---+---+---+---+---+---+---+---+
|   | . |14 |   |   |   |   | . | . | . | . |   | . | . | . |
+---+---+---+---+---+---+---+---+---+---+---+---+---+---+---+
|   | . |   | . | . | . | . | . | . | . | . |   | . | . | . |
+---+---+---+---+---+---+---+---+---+---+---+---+---+---+---+
|   | . |   | . | . | . | 6 |   |   |   |   |   | . | . | . |
+---+---+---+---+---+---+---+---+---+---+---+---+---+---+---+
|16 |   |   |   |   |   |   |   | . | . | . |   | . | . | . |
+---+---+---+---+---+---+---+---+---+---+---+---+---+---+---+ 