+---+---+---+---+---+---+---+---+---+---+---+---+---+---+---+
| . | . | . | . | R | . | W | . | . | . | . | . | . | . | . |
+---+---+---+---+---+---+---+---+---+---+---+---+---+---+---+
| . | . | . | . | O | . | A | B | U | J | A | . | . | . | . |
+---+---+---+---+---+---+---+---+---+---+---+---+---+---+---+
| . | . | . | . | M | . | S | . | . | . | . | . | . | B | . |
+---+---+---+---+---+---+---+---+---+---+---+---+---+---+---+
| N | E | W | D | E | L | H | I | . | C | . | . | . | E | . |
+---+---+---+---+---+---+---+---+---+---+---+---+---+---+---+
| . | . | . | . | . | . | I | . | . | A | . | . | . | I | . |
+---+---+---+---+---+---+---+---+---+---+---+---+---+---+---+
| . | . | . | . | L | O | N | D | O | N | . | . | . | J | . |
+---+---+---+---+---+---+---+---+---+---+---+---+---+---+---+
| . | . | . | . | . | . | G | . | . | B | E | R | L | I | N |
+---+---+---+---+---+---+---+---+---+---+---+---+---+---+---+
| . | T | O | R | O | N | T | O | . | E | . | . | . | N | . |
+---+---+---+---+---+---+---+---+---+---+---+---+---+---+---+
| . | . | . | . | . | . | O | . | . | R | . | C | . | G | . |
+---+---+---+---+---+---+---+---+---+---+---+---+---+---+---+
| C | A | P | T | O | W | N | . | . | R | . | A | . | . | . |
+---+---+---+---+---+---+---+---+---+---+---+---+---+---+---+
| . | . | . | . | T | . | D | . | P | A | R | I | S | . | S |
+---+---+---+---+---+---+---+---+---+---+---+---+---+---+---+
| . | . | . | . | T | . | C | . | . | . | . | R | . | . | E |
+---+---+---+---+---+---+---+---+---+---+---+---+---+---+---+
| . | . | . | . | A | . | . | . | . | . | T | O | K | Y | O |
+---+---+---+---+---+---+---+---+---+---+---+---+---+---+---+
| . | . | . | . | W | . | . | . | . | . | . | . | . | . | U |
+---+---+---+---+---+---+---+---+---+---+---+---+---+---+---+
| . | . | B | R | A | S | I | L | I | A | . | . | . | . | L |
+---+---+---+---+---+---+---+---+---+---+---+---+---+---+---+
