+---+---+---+---+---+---+---+---+---+---+---+---+---+---+---+
| . | . | . | . | 6 | . |10 | . | . | . | . | . | . | . | . |
+---+---+---+---+---+---+---+---+---+---+---+---+---+---+---+
| . | . | . | . |   | . |13 |   |   |   |   | . | . | . | . |
+---+---+---+---+---+---+---+---+---+---+---+---+---+---+---+
| . | . | . | . |   | . |   | . | . | . | . | . | . | 4 | . |
+---+---+---+---+---+---+---+---+---+---+---+---+---+---+---+
| 7 |   |   |   |   |   |   |   | . |14 | . | . | . |   | . |
+---+---+---+---+---+---+---+---+---+---+---+---+---+---+---+
| . | . | . | . | . | . |   | . | . |   | . | . | . |  | . |
+---+---+---+---+---+---+---+---+---+---+---+---+---+---+---+
| . | . | . | . |11 |   |   |   |   |   | . | . | . |   | . |
+---+---+---+---+---+---+---+---+---+---+---+---+---+---+---+
| . | . | . | . | . | . |   | . | . | 9 |   |   |   |   |   |
+---+---+---+---+---+---+---+---+---+---+---+---+---+---+---+
| . | 1 |   |   |   |   |   |   | . |   | . | . | . |   | . |
+---+---+---+---+---+---+---+---+---+---+---+---+---+---+---+
| . | . | . | . | . | . |   | . | . |   | . | 8 | . |   | . |
+---+---+---+---+---+---+---+---+---+---+---+---+---+---+---+
|16 |   |   |   |12 |   |   | . | . |   | . |   | . | . | . |
+---+---+---+---+---+---+---+---+---+---+---+---+---+---+---+
| . | . | . | . |   | . |   | . | 3 |   |   |   |   | . | 2 |
+---+---+---+---+---+---+---+---+---+---+---+---+---+---+---+
| . | . | . | . |   | . |   | . | . | . | . |   | . | . |   |
+---+---+---+---+---+---+---+---+---+---+---+---+---+---+---+
| . | . | . | . |   | . | . | . | . | . | 5 |   |   |   |   |
+---+---+---+---+---+---+---+---+---+---+---+---+---+---+---+
| . | . | . | . |   | . | . | . | . | . | . | . | . | . |   |
+---+---+---+---+---+---+---+---+---+---+---+---+---+---+---+
| . | . |15 |   |   |   |   |   |   |   | . | . | . | . |   |
+---+---+---+---+---+---+---+---+---+---+---+---+---+---+---+ 