+---+---+---+---+---+---+---+---+---+---+---+---+---+---+---+
| . | . | S | . | . | . | . | . | . | . | R | . | . | . | . |
+---+---+---+---+---+---+---+---+---+---+---+---+---+---+---+
| . | . | E | . | . | . | C | A | I | R | O | . | . | . | . |
+---+---+---+---+---+---+---+---+---+---+---+---+---+---+---+
| . | . | O | . | . | . | . | . | . | . | M | . | . | . | . |
+---+---+---+---+---+---+---+---+---+---+---+---+---+---+---+
| W | . | U | . | . | . | . | . | . | B | E | . | . | . | N |
+---+---+---+---+---+---+---+---+---+---+---+---+---+---+---+
| A | . | L | O | N | D | O | N | . | R | . | . | . | . | E |
+---+---+---+---+---+---+---+---+---+---+---+---+---+---+---+
| S | . | . | . | . | . | T | . | . | A | . | . | . | . | W |
+---+---+---+---+---+---+---+---+---+---+---+---+---+---+---+
| H | . | . | . | . | . | T | . | . | S | . | . | . | . | D |
+---+---+---+---+---+---+---+---+---+---+---+---+---+---+---+
| I | . | . | . | . | H | A | N | O | I | . | . | . | . | E |
+---+---+---+---+---+---+---+---+---+---+---+---+---+---+---+
| N | . | C | . | . | . | W | . | . | L | . | B | . | . | L |
+---+---+---+---+---+---+---+---+---+---+---+---+---+---+---+
| G | . | A | B | U | J | A | . | . | I | . | E | . | . | H |
+---+---+---+---+---+---+---+---+---+---+---+---+---+---+---+
| T | . | P | . | . | . | . | . | P | A | R | I | S | . | I |
+---+---+---+---+---+---+---+---+---+---+---+---+---+---+---+
| O | . | T | O | K | Y | O | . | . | . | . | J | . | . | . |
+---+---+---+---+---+---+---+---+---+---+---+---+---+---+---+
| N | . | O | . | . | . | . | . | . | . | . | I | . | . | . |
+---+---+---+---+---+---+---+---+---+---+---+---+---+---+---+
| D | . | W | . | . | . | B | E | R | L | I | N | . | . | . |
+---+---+---+---+---+---+---+---+---+---+---+---+---+---+---+
| C | A | N | B | E | R | R | A | . | . | . | G | . | . | . |
+---+---+---+---+---+---+---+---+---+---+---+---+---+---+---+
