+---+---+---+---+---+---+---+---+---+---+---+---+---+---+---+
| . | . | . | J | . | . | E | G | Y | P | T | . | . | . | . |
+---+---+---+---+---+---+---+---+---+---+---+---+---+---+---+
| C | A | N | A | D | A | . | E | . | P | O | L | A | N | D |
+---+---+---+---+---+---+---+---+---+---+---+---+---+---+---+
| . | . | . | P | . | U | . | R | . | . | . | H | . | . | . |
+---+---+---+---+---+---+---+---+---+---+---+---+---+---+---+
| . | . | . | A | . | S | . | M | . | . | . | I | . | . | . |
+---+---+---+---+---+---+---+---+---+---+---+---+---+---+---+
| . | . | . | N | . | T | H | A | I | L | A | N | D | . | . |
+---+---+---+---+---+---+---+---+---+---+---+---+---+---+---+
| A | . | . | . | . | R | . | N | . | . | . | D | . | . | . |
+---+---+---+---+---+---+---+---+---+---+---+---+---+---+---+
| R | U | S | S | I | A | . | . | I | N | D | I | A | . | . |
+---+---+---+---+---+---+---+---+---+---+---+---+---+---+---+
| A | . | P | . | . | L | . | F | . | . | . | . | . | . | . |
+---+---+---+---+---+---+---+---+---+---+---+---+---+---+---+
| B | . | A | . | . | I | . | R | . | . | U | . | . | . | . |
+---+---+---+---+---+---+---+---+---+---+---+---+---+---+---+
| I | . | N | . | J | A | P | A | N | E | S | E | . | . | . |
+---+---+---+---+---+---+---+---+---+---+---+---+---+---+---+
| C | . | I | . | . | . | . | N | . | . | A | . | . | . | . |
+---+---+---+---+---+---+---+---+---+---+---+---+---+---+---+
| . | . | S | . | . | . | . | C | . | . | . | . | . | . | . |
+---+---+---+---+---+---+---+---+---+---+---+---+---+---+---+
| . | . | H | . | . | I | R | E | L | A | N | D | . | . | . |
+---+---+---+---+---+---+---+---+---+---+---+---+---+---+---+
| . | . | . | . | . | . | . | . | . | . | . | . | . | . | . |
+---+---+---+---+---+---+---+---+---+---+---+---+---+---+---+
| . | . | . | . | . | . | . | . | . | . | . | . | . | . | . |
+---+---+---+---+---+---+---+---+---+---+---+---+---+---+---+ 