+---+---+---+---+---+---+---+---+---+---+---+---+---+---+---+
| . | . | . | J | . | . | E | G | Y | P | T | . | . | . | . |
+---+---+---+---+---+---+---+---+---+---+---+---+---+---+---+
| C | A | N | A | D | A | . | E | . | . | . | . | . | . | . |
+---+---+---+---+---+---+---+---+---+---+---+---+---+---+---+
| . | . | . | P | . | U | . | R | . | P | . | H | . | . | . |
+---+---+---+---+---+---+---+---+---+---+---+---+---+---+---+
| . | . | . | A | . | S | . | M | . | O | . | I | . | . | . |
+---+---+---+---+---+---+---+---+---+---+---+---+---+---+---+
| . | . | . | N | . | T | H | A | I | L | A | N | . | . | . |
+---+---+---+---+---+---+---+---+---+---+---+---+---+---+---+
| A | . | . | . | . | R | . | N | . | A | . | D | . | . | . |
+---+---+---+---+---+---+---+---+---+---+---+---+---+---+---+
| R | U | S | S | I | A | . | . | I | N | D | I | A | . | . |
+---+---+---+---+---+---+---+---+---+---+---+---+---+---+---+
| A | . | P | . | . | L | . | F | . | D | . | . | . | . | . |
+---+---+---+---+---+---+---+---+---+---+---+---+---+---+---+
| B | . | A | . | . | I | . | R | . | . | . | . | . | . | . |
+---+---+---+---+---+---+---+---+---+---+---+---+---+---+---+
| I | . | N | . | J | A | P | A | N | E | S | E | . | . | . |
+---+---+---+---+---+---+---+---+---+---+---+---+---+---+---+
| C | . | I | . | . | . | . | N | . | . | . | . | . | . | . |
+---+---+---+---+---+---+---+---+---+---+---+---+---+---+---+
| . | U | S | A | . | . | . | C | . | . | . | . | . | . | . |
+---+---+---+---+---+---+---+---+---+---+---+---+---+---+---+
| . | . | H | . | . | I | R | E | L | A | N | D | . | . | . |
+---+---+---+---+---+---+---+---+---+---+---+---+---+---+---+
| . | . | . | . | . | . | . | . | . | . | . | . | . | . | . |
+---+---+---+---+---+---+---+---+---+---+---+---+---+---+---+
| . | . | . | . | . | . | . | . | . | . | . | . | . | . | . |
+---+---+---+---+---+---+---+---+---+---+---+---+---+---+---+ 