+---+---+---+---+---+---+---+---+---+---+---+---+---+---+---+
| P | I | Z | Z | A | . | . | . | . | S | . | . | . | . |
+---+---+---+---+---+---+---+---+---+---+---+---+---+---+---+
| A | . | . | . | . | . | . | . | . | B | U | R | G | E | R |
+---+---+---+---+---+---+---+---+---+---+---+---+---+---+---+
| S | A | L | A | D | . | . | . | . | . | S | . | . | . | . |
+---+---+---+---+---+---+---+---+---+---+---+---+---+---+---+
| T | E | A | . | O | . | . | . | . | C | H | E | E | S | E |
+---+---+---+---+---+---+---+---+---+---+---+---+---+---+---+
| A | . | . | . | N | . | . | . | . | R | I | C | E | . | . |
+---+---+---+---+---+---+---+---+---+---+---+---+---+---+---+
| . | . | . | . | U | . | . | . | . | B | . | . | . | . | . |
+---+---+---+---+---+---+---+---+---+---+---+---+---+---+---+
| . | M | . | . | T | . | B | R | E | A | D | . | . | . | . |
+---+---+---+---+---+---+---+---+---+---+---+---+---+---+---+
| . | E | . | . | . | . | U | . | . | . | A | . | . | . | . |
+---+---+---+---+---+---+---+---+---+---+---+---+---+---+---+
| C | A | N | D | Y | . | T | . | H | O | N | E | Y | . | . |
+---+---+---+---+---+---+---+---+---+---+---+---+---+---+---+
| . | T | C | . | . | . | T | . | . | N | . | . | . | . | . |
+---+---+---+---+---+---+---+---+---+---+---+---+---+---+---+
| . | . | O | . | . | . | . | . | . | . | . | J | . | . | . |
+---+---+---+---+---+---+---+---+---+---+---+---+---+---+---+
| . | . | O | . | . | . | R | . | . | . | . | . | U | . | . |
+---+---+---+--+---+---+---+---+---+---+---+---+---+---+---+
| . | . | K | . | . | . | . | . | . | . | . | . | I | . | . |
+---+---+---+---+---+---+---+---+---+---+---+---+---+---+---+
| . | . | I | . | . | S | T | E | A | K | . | . | C | . | . |
+---+---+---+---+---+---+---+---+---+---+---+---+---+---+---+
| . | . | E | . | . | . | . | . | . | . | . | . | . | E | . |
+---+---+---+---+---+---+---+---+---+---+---+---+---+---+---+ 