+---+---+---+---+---+---+---+---+---+---+---+---+---+---+---+
| D | O | C | T | O | R | . | . | . | S | . | . | . | . | . |
+---+---+---+---+---+---+---+---+---+---+---+---+---+---+---+
| . | . | H | . | . | . | . | . | . | U | . | . | . | . | . |
+---+---+---+---+---+---+---+---+---+---+---+---+---+---+---+
| S | . | E | N | G | I | N | E | E | R | . | . | . | W | . |
+---+---+---+---+---+---+---+---+---+---+---+---+---+---+---+
| I | . | F | . | . | . | . | . | . | G | . | . | . | R | . |
+---+---+---+---+---+---+---+---+---+---+---+---+---+---+---+
| N | . | . | . | . | . | . | . | . | E | . | . | . | I | . |
+---+---+---+---+---+---+---+---+---+---+---+---+---+---+---+
| G | . | P | R | O | F | E | S | S | O | R | . | . | T | . |
+---+---+---+---+---+---+---+---+---+---+---+---+---+---+---+
| E | . | . | . | . | . | . | . | . | N | U | R | S | E | . |
+---+---+---+---+---+---+---+---+---+---+---+---+---+---+---+
| R | . | . | . | . | P | . | . | . | . | . | . | . | R | . |
+---+---+---+---+---+---+---+---+---+---+---+---+---+---+---+
| . | . | A | R | T | I | S | T | . | . | . | D | . | . | . |
+---+---+---+---+---+---+---+---+---+---+---+---+---+---+---+
| F | . | . | . | . | l | . | . | A | . | . | A | . | . | . |
+---+---+---+---+---+---+---+---+---+---+---+---+---+---+---+
| A | . | . | . | P | O | L | I | C | E | . | N | . | . | . |
+---+---+---+---+---+---+---+---+---+---+---+---+---+---+---+
| M | . | . | . | . | T | . | . | T | E | A | C | H | E | R |
+---+---+---+---+---+---+---+---+---+---+---+---+---+---+---+
| E | . | . | . | . | . | . | . | O | . | . | E | . | . | . |
+---+---+---+---+---+---+---+---+---+---+---+---+---+---+---+
| R | . | . | . | B | A | K | E | R | . | . | R | . | . | . |
+---+---+---+---+---+---+---+---+---+---+---+---+---+---+---+