+---+---+---+---+---+---+---+---+---+---+---+---+---+---+---+
| 2 |   | 1 |   |   |   | . | . | . | 3 | . | . | . | . | . |
+---+---+---+---+---+---+---+---+---+---+---+---+---+---+---+
| . | . |   | . | . | . | . | . | . |   | . | . | . | . | . |
+---+---+---+---+---+---+---+---+---+---+---+---+---+---+---+
| 7 | . | 4 |   |   |   |   |   |   |   | . | . | . | 5 | . |
+---+---+---+---+---+---+---+---+---+---+---+---+---+---+---+
|   | . |   | . | . | . | . | . | . |   | . | . | . |   | . |
+---+---+---+---+---+---+---+---+---+---+---+---+---+---+---+
|   | . | . | . | . | . | . | . | . |   | . | . | . |   | . |
+---+---+---+---+---+---+---+---+---+---+---+---+---+---+---+
|   | . | 6 |   |   |   |   |   |   |   |   | . | . |   | . |
+---+---+---+---+---+---+---+---+---+---+---+---+---+---+---+
|   | . | . | . | . | . | . | . | . | 8 |   |   |   |   | . |
+---+---+---+---+---+---+---+---+---+---+---+---+---+---+---+
|   | . | . | . | . | 9 | . | . | . | . | . | . | . |   | . |
+---+---+---+---+---+---+---+---+---+---+---+---+---+---+---+
| . | . |10 |   |   |   |   |   | . | . | . |13 | . | . | . |
+---+---+---+---+---+---+---+---+---+---+---+---+---+---+---+
|11 | . | . | . | . |   | . | . |15 | . | . |   | . | . | . |
+---+---+---+---+---+---+---+---+---+---+---+---+---+---+---+
|   | . | . | . |12 |   |   |   |   |   | . |   | . | . | . |
+---+---+---+---+---+---+---+---+---+---+---+---+---+---+---+
|   | . | . | . | . |   | . | . |14 |   |   |   |   |   |   |
+---+---+---+---+---+---+---+---+---+---+---+---+---+---+---+
|   | . | . | . | . | . | . | . |   | . | . |   | . | . | . |
+---+---+---+---+---+---+---+---+---+---+---+---+---+---+---+
|   | . | . | . |16 |   |   |   |   | . | . |   | . | . | . |
+---+---+---+---+---+---+---+---+---+---+---+---+---+---+---+
