+---+---+---+---+---+---+---+---+---+---+---+---+---+---+---+
| . | . | . | . | . | . | . | . | . | . | . | . | . | . | . |
+---+---+---+---+---+---+---+---+---+---+---+---+---+---+---+
| T | I | G | E | R | . | . | . | . | F | I | S | H | . | . |
+---+---+---+---+---+---+---+---+---+---+---+---+---+---+---+
| . | . | . | A | . | . | . | . | . | R | . | H | . | . | . |
+---+---+---+---+---+---+---+---+---+---+---+---+---+---+---+
| . | . | . | G | . | . | . | . | . | O | . | A | . | . | . |
+---+---+---+---+---+---+---+---+---+---+---+---+---+---+---+
| T | . | . | L | I | O | N | . | . | G | . | R | . | . | . |
+---+---+---+---+---+---+---+---+---+---+---+---+---+---+---+
| U | . | . | E | . | C | . | . | . | . | . | K | . | . | . |
+---+---+---+---+---+---+---+---+---+---+---+---+---+---+---+
| R | . | . | . | . | T | . | . | H | . | . | . | G | . | . |
+---+---+---+---+---+---+---+---+---+---+---+---+---+---+---+
| T | . | . | . | . | O | . | . | D | O | L | P | H | I | N |
+---+---+---+---+---+---+---+---+---+---+---+---+---+---+---+
| L | . | . | . | . | P | . | . | . | R | . | . | . | R | . |
+---+---+---+---+---+---+---+---+---+---+---+---+---+---+---+
| E | . | . | . |   | U | . | . | . | S | . | . | . | A | . |
+---+---+---+---+---+---+---+---+---+---+---+---+---+---+---+
| . | . | . | . | . | S | N | A | K | E | . | . | . | F | . |
+---+---+---+---+---+---+---+---+---+---+---+---+---+---+---+
| Z | E | B | R | A | . | . | . | . | . | . | . | . | F | . |
+---+---+---+---+---+---+---+---+---+---+---+---+---+---+---+
| . | . | E | . | . | . | . | . | . | M | O | N | K | E | Y |
+---+---+---+---+---+---+---+---+---+---+---+---+---+---+---+
| . | . | A | . | . | . | . | . | . | . | . | . | . | . | . |
+---+---+---+---+---+---+---+---+---+---+---+---+---+---+---+
| . | . | R | . | . | . | . | . | . | . | . | . | . | . | . |
+---+---+---+---+---+---+---+---+---+---+---+---+---+---+---+ 