+---+---+---+---+---+---+---+---+---+---+---+---+---+---+---+
| . | . | . | . | . | . | . | . | . | . | . | . | . | . | . |
+---+---+---+---+---+---+---+---+---+---+---+---+---+---+---+
| T | I | G | E | R | . | . | . | . | F | I | S | H | . | . |
+---+---+---+---+---+---+---+---+---+---+---+---+---+---+---+
| U | . | . | A | . | . | . | . | . | R | . | H | . | . | . |
+---+---+---+---+---+---+---+---+---+---+---+---+---+---+---+
| R | . | . | G | . | . | . | . | . | O | . | A | . | . | . |
+---+---+---+---+---+---+---+---+---+---+---+---+---+---+---+
| T | . | . | L | I | O | N | . | . | G | . | R | . | . | . |
+---+---+---+---+---+---+---+---+---+---+---+---+---+---+---+
| L | . | . | E | . | C | . | . | . | . | . | K | . | . | . |
+---+---+---+---+---+---+---+---+---+---+---+---+---+---+---+
| E | . | . | . | . | T | . | . | H | . | . | . | G | . | . |
+---+---+---+---+---+---+---+---+---+---+---+---+---+---+---+
| . | . | . | . | . | O | . | . | D | O | L | P | H | I | N |
+---+---+---+---+---+---+---+---+---+---+---+---+---+---+---+
| . | . | . | . | . | P | . | . | . | R | . | . | . | R | . |
+---+---+---+---+---+---+---+---+---+---+---+---+---+---+---+
| . | . | . | . |   | U | . | . | . | S | . | . | . | A | . |
+---+---+---+---+---+---+---+---+---+---+---+---+---+---+---+
| . | . | . | . | . | S | N | A | K | E | . | . | . | F | . |
+---+---+---+---+---+---+---+---+---+---+---+---+---+---+---+
| Z | E | B | R | A | . | . | . | . | . | . | . | . | F | . |
+---+---+---+---+---+---+---+---+---+---+---+---+---+---+---+
| . | . | E | . | . | . | . | . | . | M | O | N | K | E | Y |
+---+---+---+---+---+---+---+---+---+---+---+---+---+---+---+
| . | . | A | . | . | . | . | . | . | . | . | . | . | . | . |
+---+---+---+---+---+---+---+---+---+---+---+---+---+---+---+
| . | . | R | . | . | . | . | . | . | . | . | . | . | . | . |
+---+---+---+---+---+---+---+---+---+---+---+---+---+---+---+ 