+---+---+---+---+---+---+---+---+---+---+---+---+---+---+---+
| . | . | . | . | . | . | . | . | . | . | . | . | . | . | . |
+---+---+---+---+---+---+---+---+---+---+---+---+---+---+---+
| 1 |   |   | 3 |   | . | . | . | . | 4 |   | 7 |   | . | . |
+---+---+---+---+---+---+---+---+---+---+---+---+---+---+---+
|   | . | . |   | . | . | . | . | . |   | . |   | . | . | . |
+---+---+---+---+---+---+---+---+---+---+---+---+---+---+---+
|   | . | . |   | . | . | . | . | . |   | . | 8 |   |   | . |
+---+---+---+---+---+---+---+---+---+---+---+---+---+---+---+
|   | . | . | 6 |   | 9 |   | . | . |   | . |   | . | . | . |
+---+---+---+---+---+---+---+---+---+---+---+---+---+---+---+
|   | . | . |   | . |   | . | . | . | . | . |   | . | . | . |
+---+---+---+---+---+---+---+---+---+---+---+---+---+---+---+
|   | . | . | . | . |   | . | . |11 | . | . | . |13 | . | . |
+---+---+---+---+---+---+---+---+---+---+---+---+---+---+---+
| . | . | . | . | . |   | . | . |10 |   |   |   |   |   |   |
+---+---+---+---+---+---+---+---+---+---+---+---+---+---+---+
| . | . | . | . | . |   | . | . | . |   | . | . | . |   | . |
+---+---+---+---+---+---+---+---+---+---+---+---+---+---+---+
| . | . | . | . |   |   | . | . | . |   | . | . | . |   | . |
+---+---+---+---+---+---+---+---+---+---+---+---+---+---+---+
| . | . | . | . | . |14 |   |   |   |   | . | . | . |   | . |
+---+---+---+---+---+---+---+---+---+---+---+---+---+---+---+
|12 |   |15 |   |   | . | . | . | . | . | . | . | . |   | . |
+---+---+---+---+---+---+---+---+---+---+---+---+---+---+---+
| . | . |   | . | . | . | . | . | . |16 |   |   |   |   |   |
+---+---+---+---+---+---+---+---+---+---+---+---+---+---+---+
| . | . |   | . | . | . | . | . | . | . | . | . | . | . | . |
+---+---+---+---+---+---+---+---+---+---+---+---+---+---+---+
| . | . |   | . | . | . | . | . | . | . | . | . | . | . | . |
+---+---+---+---+---+---+---+---+---+---+---+---+---+---+---+ 